40,40,3
1,1,1,1,1,1,1,1,1,1,1,1,1,1,1,1,1,1,1,1,1,1,1,1,1,1,1,1,1,1,1,1,1,1,1,1,1,1,1,1
1,1,1,1,1,1,1,1,1,1,1,1,1,1,1,1,1,1,1,1,1,1,1,1,1,1,1,1,1,1,1,1,1,1,1,1,1,1,1,1
1,1,1,1,1,1,1,1,1,1,1,1,1,1,1,1,1,1,1,1,1,1,1,1,1,1,1,1,1,1,1,1,1,1,1,1,1,1,1,1
1,1,1,1,1,1,1,1,1,1,1,1,1,1,1,1,1,1,1,1,1,1,1,1,1,1,1,1,1,1,1,1,1,1,1,1,1,1,1,1
1,1,1,1,1,1,1,1,1,1,1,1,1,1,1,1,1,1,1,1,1,1,1,1,1,1,1,1,1,1,1,1,1,1,1,1,1,1,1,1
1,1,1,1,1,1,1,1,1,1,1,1,1,1,1,1,1,1,1,1,1,1,1,1,1,1,1,1,1,1,1,1,1,1,1,1,1,1,1,1
1,1,1,1,1,1,1,1,1,1,1,1,1,1,1,1,1,1,1,1,1,1,1,1,1,1,1,1,1,1,1,1,1,1,1,1,1,1,1,1
1,1,1,1,1,1,1,1,1,1,1,1,1,1,1,1,1,1,1,1,1,1,1,1,1,1,1,1,1,1,1,1,1,1,1,1,1,1,1,1
1,1,1,1,1,1,1,1,1,1,1,1,1,1,1,1,1,1,2,2,2,2,1,1,1,1,1,1,1,1,1,1,1,1,1,1,1,1,1,1
1,1,1,1,1,0,0,0,0,0,0,0,0,0,0,0,1,1,2,2,2,2,1,1,0,0,0,0,0,0,0,0,0,0,0,1,1,1,1,1
1,1,1,1,1,0,0,0,0,0,0,0,0,0,0,0,1,1,0,0,0,0,1,1,0,0,0,0,0,0,0,0,0,0,0,1,1,1,1,1
1,1,1,1,1,0,0,0,0,0,0,0,0,0,0,0,0,0,0,0,0,0,0,0,0,0,0,0,0,0,0,0,0,0,0,1,1,1,1,1
1,1,1,1,1,0,0,0,0,0,0,0,0,0,0,0,0,0,0,0,0,0,0,0,0,0,0,0,0,0,0,0,0,0,0,1,1,1,1,1
1,1,1,1,1,0,0,0,0,0,0,0,0,0,0,0,0,0,0,0,0,0,0,0,0,0,0,0,0,0,0,0,0,0,0,1,1,1,1,1
1,1,1,1,1,0,0,0,0,0,0,0,0,0,0,0,0,0,0,0,0,0,0,0,0,0,0,0,0,0,0,0,0,0,0,1,1,1,1,1
1,1,1,1,1,0,0,0,0,0,0,0,0,0,0,0,0,0,0,0,0,0,0,0,0,0,0,0,0,0,0,0,0,0,0,1,1,1,1,1
1,1,1,1,1,0,0,0,0,0,0,0,0,0,0,0,0,0,0,0,0,0,0,0,0,0,0,0,0,0,0,0,0,0,0,1,1,1,1,1
1,1,1,1,1,0,0,0,0,0,0,0,0,0,0,0,0,0,0,0,0,0,0,0,0,0,0,0,0,0,0,0,0,0,0,1,1,1,1,1
1,1,1,1,1,0,0,0,0,0,0,0,0,0,0,0,0,0,0,0,0,0,0,0,0,0,0,0,0,0,0,0,0,0,0,1,1,1,1,1
1,1,1,1,2,0,0,0,0,0,0,0,0,0,0,0,0,0,0,0,0,0,0,0,0,0,0,0,0,0,0,0,0,0,0,2,1,1,1,1
1,1,1,1,2,0,0,0,0,0,0,0,0,0,0,0,0,0,0,0,0,0,0,0,0,0,0,0,0,0,0,0,0,0,0,2,1,1,1,1
1,1,1,1,2,0,0,0,0,0,0,0,0,0,0,0,0,0,0,0,0,0,0,0,0,0,0,0,0,0,0,0,0,0,0,2,1,1,1,1
1,1,1,1,2,0,0,0,0,0,0,0,0,0,0,0,0,0,0,0,0,0,0,0,0,0,0,0,0,0,0,0,0,0,0,2,1,1,1,1
1,1,1,1,1,0,0,0,0,0,0,0,0,0,0,0,0,0,0,0,0,0,0,0,0,0,0,0,0,0,0,0,0,0,0,1,1,1,1,1
1,1,1,1,1,0,0,0,0,0,0,0,0,0,0,0,0,0,0,0,0,0,0,0,0,0,0,0,0,0,0,0,0,0,0,1,1,1,1,1
1,1,1,1,1,0,0,0,0,0,0,0,0,0,0,0,0,0,0,0,0,0,0,0,0,0,0,0,0,0,0,0,0,0,0,1,1,1,1,1
1,1,1,1,1,0,0,0,0,0,0,0,0,0,0,0,0,0,0,0,0,0,0,0,0,0,0,0,0,0,0,0,0,0,0,1,1,1,1,1
1,1,1,1,1,0,0,0,0,0,0,0,0,0,0,0,0,0,0,0,0,0,0,0,0,0,0,0,0,0,0,0,0,0,0,1,1,1,1,1
1,1,1,1,1,0,0,0,0,0,0,0,0,0,0,0,0,0,0,0,0,0,0,0,0,0,0,0,0,0,0,0,0,0,0,1,1,1,1,1
1,1,1,1,1,0,0,0,0,0,0,0,0,0,0,0,0,0,0,0,0,0,0,0,0,0,0,0,0,0,0,0,0,0,0,1,1,1,1,1
1,1,1,1,1,0,0,0,0,0,0,0,0,0,0,0,0,0,0,0,0,0,0,0,0,0,0,0,0,0,0,0,0,0,0,1,1,1,1,1
1,1,1,1,1,0,0,0,0,0,0,0,0,0,0,0,0,0,0,0,0,0,0,0,0,0,0,0,0,0,0,0,0,0,0,1,1,1,1,1
1,1,1,1,1,0,0,0,0,0,0,0,0,0,0,0,0,0,0,0,0,0,0,0,0,0,0,0,0,0,0,0,0,0,0,1,1,1,1,1
1,1,1,1,1,0,0,0,0,0,0,0,0,0,0,0,0,0,0,0,0,0,0,0,0,0,0,0,0,0,0,0,0,0,0,1,1,1,1,1
1,1,1,1,1,0,0,0,0,0,0,0,0,0,0,0,0,0,0,0,0,0,0,0,0,0,0,0,0,0,0,0,0,0,0,1,1,1,1,1
1,1,1,1,1,1,1,1,1,1,1,1,1,1,1,1,1,1,2,2,2,2,1,1,1,1,1,1,1,1,1,1,1,1,1,1,1,1,1,1
1,1,1,1,1,1,1,1,1,1,1,1,1,1,1,1,1,1,1,1,1,1,1,1,1,1,1,1,1,1,1,1,1,1,1,1,1,1,1,1
1,1,1,1,1,1,1,1,1,1,1,1,1,1,1,1,1,1,1,1,1,1,1,1,1,1,1,1,1,1,1,1,1,1,1,1,1,1,1,1
1,1,1,1,1,1,1,1,1,1,1,1,1,1,1,1,1,1,1,1,1,1,1,1,1,1,1,1,1,1,1,1,1,1,1,1,1,1,1,1
1,1,1,1,1,1,1,1,1,1,1,1,1,1,1,1,1,1,1,1,1,1,1,1,1,1,1,1,1,1,1,1,1,1,1,1,1,1,1,1


6182,6182,6182,6182,6182,6182,6182,6182,6182,6182,6182,6182,6182,6344,6344,6182,6182,6182,6182,6182,6182,6182,6182,6182,6182,6182,6182,6182,6182,6182,6182,6182,6182,6182,6182,6182,6183,6184,6185,6186,
6344,6344,6344,6344,6344,6344,6344,6344,6344,6344,6344,6344,6344,6506,6506,6344,6344,6344,6344,6344,6344,6344,6344,6344,6344,6344,6344,6344,6344,6344,6344,6344,6344,6344,6344,6182,6183,6184,6185,6186,
6506,6506,6506,6506,6506,6506,6506,6506,6506,6506,6506,6506,6506,6668,6668,6506,6506,6506,6506,6506,6506,6506,6506,6506,6506,6506,6506,6506,6506,6506,6506,6506,6506,6506,6506,6182,6183,6184,6185,6186,
6668,6668,6668,6668,6668,6668,6668,6668,6668,6668,6668,6668,6668,6830,6830,6668,6668,6668,6668,6668,6668,6668,6668,6668,6668,6668,6668,6668,6668,6668,6668,6668,6668,6668,6668,6182,6183,6184,6185,6186,
6830,6830,6830,6830,109,110,111,112,110,110,110,110,110,110,111,110,111,112,113,113,113,113,113,113,113,113,113,113,113,113,113,113,113,113,113,114,6183,6184,6185,6186,
6830,6831,6832,6833,147,6374,6374,6374,6374,6374,6374,6374,6374,6374,6374,6374,6374,6374,6374,6374,6374,6374,6374,6374,6374,6374,6374,6374,6374,6374,6374,6374,6374,6374,6374,152,6183,6184,6185,6186,
6830,6831,6832,6833,185,6374,6374,6374,6374,6374,6374,6374,6374,6374,6374,6374,6374,6374,6374,6374,6374,6374,6374,6374,6374,6374,6374,6374,6374,6374,6374,6374,6374,6374,6374,152,6183,6184,6185,6186,
6830,6831,6832,6833,223,6374,6374,6374,6374,6374,6374,6374,6374,6374,6374,6374,6374,6374,6374,6374,6374,6374,6374,6374,6374,6374,6374,6374,6374,6374,6374,6374,6374,6374,6374,152,6183,6184,6185,6186,
6830,6831,6832,6833,261,6374,6374,6374,6374,6374,6374,6374,6374,6374,6374,6374,6374,6374,6374,6374,6374,6374,6374,6374,6374,6374,6374,6374,6374,6374,6374,6374,6374,6374,6374,152,6183,6184,6185,6186,
6830,6831,6832,6833,261,6374,6374,6374,6374,6374,6374,6374,6374,6374,6374,6374,5527,5528,6374,6374,6374,6374,5527,5528,6374,6374,6374,6374,6374,6374,6374,6374,6374,6374,6374,152,6183,6184,6185,6186,
6830,6831,6832,6833,261,6374,6374,6374,6374,6374,6374,6374,6374,6374,6374,6374,5689,5690,5527,5528,5527,5528,5689,5690,6374,6374,6374,6374,6374,6374,6374,6374,6374,6374,6374,152,6182,6183,6184,6185,
6830,6831,6832,6833,261,6374,6374,6374,6374,6374,6374,6374,6374,6374,6374,6374,5527,5528,5689,5690,5689,5690,5689,5690,6374,6374,6374,6374,6374,6374,6374,6374,6374,6374,6374,152,6182,6183,6184,6185,
6830,6831,6832,6833,261,6374,6374,6374,6374,6374,6374,6374,6374,6374,6374,6374,5527,5528,5527,5528,5527,5528,5527,5528,6374,6374,6374,6374,6374,6374,6374,6374,6374,6374,6374,152,6183,6184,6185,6186,
6830,6831,6832,6833,261,6374,6374,6374,6374,6374,6374,6374,6374,6374,6374,6374,5689,5690,5689,5690,5689,5690,5689,5690,6374,6374,6374,6374,6374,6374,6374,6374,6374,6374,6374,152,6183,6184,6185,6186,
6831,6832,6833,6834,261,6374,6374,6374,6374,6374,6374,6374,6374,6374,6374,6374,6374,6374,6374,6374,6374,6374,6374,6374,6374,6374,6374,6374,6374,6374,6374,6374,6374,6374,6374,152,6183,6184,6185,6186,
6831,6832,6833,6834,261,6374,6374,6374,6374,6374,6374,6374,6374,6374,6374,6374,6374,6374,6374,6374,6374,6374,6374,6374,6374,6374,6374,6374,6374,6374,6374,6374,6374,6374,6374,190,6183,6184,6185,6186,
6830,6831,6832,6833,261,6374,6374,6374,6374,6374,6374,6374,6374,6374,6374,6374,6374,6374,6374,6374,6374,6374,6374,6374,6374,6374,6374,6374,6374,6374,6374,6374,6374,6374,6374,228,6183,6184,6185,6186,
6830,6831,6832,6833,261,6374,6374,6374,6374,6374,6374,6374,6374,6374,6374,6374,6374,6374,6374,6374,6374,6374,6374,6374,6374,6374,6374,6374,6374,6374,6374,6374,6374,6374,6374,152,6182,6183,6184,6185,
6830,6831,6832,6833,261,6374,6374,6374,6374,6374,6374,6374,6374,6374,6374,6374,6374,6374,6374,6374,6374,6374,6374,6374,6374,6374,6374,6374,6374,6374,6374,6374,6374,6374,6374,190,6182,6183,6184,6185,
6830,6831,6832,6833,261,6374,6374,6374,6374,6374,6374,6374,6374,6374,6374,6374,6374,6374,6374,6374,6374,6374,6374,6374,6374,6374,6374,6374,6374,6374,6374,6374,6374,6374,6374,228,6182,6183,6184,6185,
6830,6831,6832,6833,261,6374,6374,6374,6374,6374,6374,6374,6374,6374,6374,6374,6374,6374,6374,6374,6374,6374,6374,6374,6374,6374,6374,6374,6374,6374,6374,6374,6374,6374,6374,266,6183,6184,6185,6186,
6830,6831,6832,6833,261,6374,6374,6374,6374,6374,6374,6374,6374,6374,6374,6374,6374,6374,6374,6374,6374,6374,6374,6374,6374,6374,6374,6374,6374,6374,6374,6374,6374,6374,6374,266,6183,6184,6185,6186,
6830,6831,6832,6833,261,6374,6374,6374,6374,6374,6374,6374,6374,6374,6374,6374,6374,6374,6374,6374,6374,6374,6374,6374,6374,6374,6374,6374,6374,6374,6374,6374,6374,6374,6374,266,6183,6184,6185,6186,
6830,6831,6832,6833,261,6374,6374,6374,6374,6374,6374,6374,6374,6374,6374,6374,6374,6374,6374,6374,6374,6374,6374,6374,6374,6374,6374,6374,6374,6374,6374,6374,6374,6374,6374,266,6183,6184,6185,6186,
6830,6831,6832,6833,261,6374,6374,6374,6374,6374,6374,6374,6374,6374,6374,6374,6374,6374,6374,6374,6374,6374,6374,6374,6374,6374,6374,6374,6374,6374,6374,6374,6374,6374,6374,266,6183,6184,6185,6186,
6830,6831,6832,6833,261,6374,6374,6374,6374,6374,6374,6374,6374,6374,6374,6374,6374,6374,6374,6374,6374,6374,6374,6374,6374,6374,6374,6374,6374,6374,6374,6374,6374,6374,6374,266,6183,6184,6185,6186,
6830,6831,6832,6833,261,6374,6374,6374,6374,6374,6374,6374,6374,6374,6374,6374,6374,6374,6374,6374,6374,6374,6374,6374,6374,6374,6374,6374,6374,6374,6374,6374,6374,6374,6374,266,6183,6184,6185,6186,
6830,6831,6832,6833,261,6374,6374,6374,6374,6374,6374,6374,6374,6374,6374,6374,6374,6374,6374,6374,6374,6374,6374,6374,6374,6374,6374,6374,6374,6374,6374,6374,6374,6374,6374,266,6183,6184,6185,6186,
6830,6831,6832,6833,261,6374,6374,6374,6374,6374,6374,6374,6374,6374,6374,6374,6374,6374,6374,6374,6374,6374,6374,6374,6374,6374,6374,6374,6374,6374,6374,6374,6374,6374,6374,266,6183,6184,6185,6186,
6830,6831,6832,6833,261,6374,6374,6374,6374,6374,6374,6374,6374,6374,6374,6374,6374,6374,6374,6374,6374,6374,6374,6374,6374,6374,6374,6374,6374,6374,6374,6374,6374,6374,6374,266,6183,6184,6185,6186,
6830,6831,6832,6833,261,6374,6374,6374,6374,6374,6374,6374,6374,6374,6374,6374,6374,6374,6374,6374,6374,6374,6374,6374,6374,6374,6374,6374,6374,6374,6374,6374,6374,6374,6374,266,6182,6183,6184,6185,
6830,6831,6832,6833,261,6374,6374,6374,6374,6374,6374,6374,6374,6374,6374,6374,6374,6374,6374,6374,6374,6374,6374,6374,6374,6374,6374,6374,6374,6374,6374,6374,6374,6374,6374,266,6182,6183,6184,6185,
6830,6831,6832,6833,261,6374,6374,6374,6374,6374,6374,6374,6374,6374,6374,6374,6374,6374,6374,6374,6374,6374,6374,6374,6374,6374,6374,6374,6374,6374,6374,6374,6374,6374,6374,266,6182,6183,6184,6185,
6830,6831,6832,6833,261,6374,6374,6374,6374,6374,6374,6374,6374,6374,6374,6374,6374,6374,6374,6374,6374,6374,6374,6374,6374,6374,6374,6374,6374,6374,6374,6374,6374,6374,6374,266,6182,6183,6184,6185,
6830,6831,6832,6833,261,6374,6374,6374,6374,6374,6374,6374,6374,6374,6374,6374,6374,6374,6374,6374,6374,6374,6374,6374,6374,6374,6374,6374,6374,6374,6374,6374,6374,6374,6374,266,6182,6183,6184,6185,
6830,6831,6832,6833,299,300,301,302,303,303,303,303,303,303,303,303,303,303,303,303,303,303,303,303,303,303,303,303,303,303,303,303,303,303,303,304,6186,6186,6186,6186,
6830,6831,6832,6833,6344,6345,6346,6347,6348,6348,6348,6348,6348,6348,6186,6186,6186,6186,6348,6348,6348,6348,6348,6348,6348,6348,6348,6185,6186,6186,6186,6348,6348,6348,6348,6348,6348,6348,6348,6348,
6830,6831,6832,6833,6506,6507,6508,6509,6510,6510,6510,6510,6510,6510,6348,6348,6348,6348,6510,6510,6510,6510,6510,6510,6510,6510,6510,6347,6348,6348,6348,6510,6510,6510,6510,6510,6510,6510,6510,6510,
6830,6831,6832,6833,6668,6669,6670,6671,6672,6672,6672,6672,6672,6672,6510,6510,6510,6510,6672,6672,6672,6672,6672,6672,6672,6672,6672,6509,6510,6510,6510,6672,6672,6672,6672,6672,6672,6672,6672,6672,
6830,6831,6832,6833,6830,6831,6832,6833,6834,6834,6834,6834,6834,6834,6672,6672,6672,6672,6834,6834,6834,6834,6834,6834,6834,6834,6834,6671,6672,6672,6672,6834,6834,6834,6834,6834,6834,6834,6834,6834
</data>
 </layer>
 <layer name="配置１" width="40" height="40">
  <data encoding="csv">
0,0,0,0,0,0,0,0,0,0,0,0,0,0,0,0,0,0,0,0,0,0,0,0,0,0,0,0,0,0,0,0,0,0,0,0,0,0,0,0,
0,0,0,0,0,0,0,0,0,0,0,0,0,0,0,0,0,0,0,0,0,0,0,0,0,0,0,0,0,0,0,0,0,0,0,0,0,0,0,0,
0,0,0,0,0,0,0,0,0,0,0,0,0,0,0,0,0,0,0,0,0,0,0,0,0,0,0,0,0,0,0,0,0,0,0,0,0,0,0,0,
0,0,0,0,0,0,0,0,0,0,0,0,0,0,0,0,0,0,0,0,0,0,0,0,0,0,0,0,0,0,0,0,0,0,0,0,0,0,0,0,
0,0,0,0,0,0,0,0,0,0,0,0,0,0,0,0,0,0,0,0,0,0,0,0,0,0,0,0,0,0,0,0,0,0,0,0,0,0,0,0,
0,0,0,0,0,311,312,313,314,315,316,317,318,311,312,313,314,315,316,317,318,311,312,313,314,315,316,317,318,311,312,313,314,315,316,0,0,0,0,0,
0,0,0,0,0,473,474,475,476,477,478,479,480,473,474,475,476,477,478,479,480,473,474,475,476,477,478,479,480,473,474,475,476,477,478,0,0,0,0,0,
0,0,0,0,0,311,312,313,314,315,316,317,318,311,312,313,314,315,316,317,318,311,312,313,314,315,316,317,318,311,312,313,314,315,316,0,0,0,0,0,
0,0,0,0,0,473,474,475,476,477,478,479,480,473,474,475,476,477,478,479,480,473,474,475,476,477,478,479,480,473,474,475,476,477,478,0,0,0,0,0,
0,0,0,0,0,0,0,0,0,0,0,0,0,0,0,0,0,0,0,0,0,0,0,0,0,0,0,0,0,0,0,0,0,0,0,0,0,0,0,0,
0,0,0,0,0,0,0,0,0,0,0,0,0,0,0,0,0,0,0,0,0,0,0,0,0,0,0,0,0,0,0,0,0,0,0,0,0,0,0,0,
0,0,0,0,0,0,0,0,0,0,0,0,0,0,0,0,0,0,0,0,0,0,0,0,0,0,0,0,0,0,0,0,0,0,0,0,0,0,0,0,
0,0,0,0,0,0,0,0,0,0,0,0,0,0,0,0,0,0,0,0,0,0,0,0,0,0,0,0,0,0,0,0,0,0,0,0,0,0,0,0,
0,0,0,0,0,0,0,0,0,0,0,0,0,0,0,0,0,0,0,0,0,0,0,0,0,0,0,0,0,0,0,0,0,0,0,0,0,0,0,0,
0,0,0,0,0,0,0,0,0,0,0,0,0,0,0,0,0,0,0,0,0,0,0,0,0,0,0,0,0,0,0,0,0,0,0,0,0,0,0,0,
0,0,0,0,0,0,0,0,0,0,0,0,0,0,0,0,0,0,0,0,0,0,0,0,0,0,0,0,0,0,0,0,0,0,0,0,0,0,0,0,
0,0,0,0,0,0,0,0,0,0,0,0,0,0,0,0,0,0,0,0,0,0,0,0,0,0,0,0,0,0,0,0,0,0,0,0,0,0,0,0,
0,0,0,0,0,0,0,0,0,0,0,0,0,0,0,0,0,0,0,0,0,0,0,0,0,0,0,0,0,0,0,0,0,0,0,0,0,0,0,0,
0,0,0,0,0,0,0,0,0,0,0,0,0,0,0,0,0,0,0,0,0,0,0,0,0,0,0,0,0,0,0,0,0,0,0,0,0,0,0,0,
0,0,0,0,0,0,0,0,0,0,0,0,0,0,0,0,0,0,0,0,0,0,0,0,0,0,0,0,0,0,0,0,0,0,0,0,0,0,0,0,
0,0,0,0,0,0,0,0,0,0,0,0,0,0,0,0,0,0,0,0,0,0,0,0,0,0,0,0,0,0,0,0,0,0,0,0,0,0,0,0,
0,0,0,0,0,0,0,0,0,0,0,0,0,0,0,0,0,0,0,0,0,0,0,0,0,0,0,0,0,0,0,0,0,0,0,0,0,0,0,0,
0,0,0,0,0,0,0,0,0,0,0,0,0,0,0,0,0,0,0,0,0,0,0,0,0,0,0,0,0,0,0,0,0,0,0,0,0,0,0,0,
0,0,0,0,0,0,0,0,0,0,0,0,0,0,0,0,0,0,0,0,0,0,0,0,0,0,0,0,0,0,0,0,0,0,0,0,0,0,0,0,
0,0,0,0,0,0,0,0,0,0,0,0,0,0,0,0,0,0,0,0,0,0,0,0,0,0,0,0,0,0,0,0,0,0,0,0,0,0,0,0,
0,0,0,0,0,0,0,0,0,0,0,0,0,0,0,0,0,0,0,0,0,0,0,0,0,0,0,0,0,0,0,0,0,0,0,0,0,0,0,0,
0,0,0,0,0,0,0,0,0,0,0,0,0,0,0,0,0,0,0,0,0,0,0,0,0,0,0,0,0,0,0,0,0,0,0,0,0,0,0,0,
0,0,0,0,0,0,0,0,0,0,0,0,0,0,0,0,0,0,0,0,0,0,0,0,0,0,0,0,0,0,0,0,0,0,0,0,0,0,0,0,
0,0,0,0,0,0,0,0,0,0,0,0,0,0,0,0,0,0,0,0,0,0,0,0,0,0,0,0,0,0,0,0,0,0,0,0,0,0,0,0,
0,0,0,0,0,0,0,0,0,0,0,0,0,0,0,0,0,0,0,0,0,0,0,0,0,0,0,0,0,0,0,0,0,0,0,0,0,0,0,0,
0,0,0,0,0,0,0,0,0,0,0,0,0,0,0,0,0,0,0,0,0,0,0,0,0,0,0,0,0,0,0,0,0,0,0,0,0,0,0,0,
0,0,0,0,0,0,0,0,0,0,0,0,0,0,0,0,0,0,0,0,0,0,0,0,0,0,0,0,0,0,0,0,0,0,0,0,0,0,0,0,
0,0,0,0,0,0,0,0,0,0,0,0,0,0,0,0,0,0,0,0,0,0,0,0,0,0,0,0,0,0,0,0,0,0,0,0,0,0,0,0,
0,0,0,0,0,0,0,0,0,0,0,0,0,0,0,0,0,0,0,0,0,0,0,0,0,0,0,0,0,0,0,0,0,0,0,0,0,0,0,0,
0,0,0,0,0,0,0,0,0,0,0,0,0,0,0,0,0,0,0,0,0,0,0,0,0,0,0,0,0,0,0,0,0,0,0,0,0,0,0,0,
0,0,0,0,0,0,0,0,0,0,0,0,0,0,0,0,0,0,0,0,0,0,0,0,0,0,0,0,0,0,0,0,0,0,0,0,0,0,0,0,
0,0,0,0,0,0,0,0,0,0,0,0,0,0,0,0,0,0,0,0,0,0,0,0,0,0,0,0,0,0,0,0,0,0,0,0,0,0,0,0,
0,0,0,0,0,0,0,0,0,0,0,0,0,0,0,0,0,0,0,0,0,0,0,0,0,0,0,0,0,0,0,0,0,0,0,0,0,0,0,0,
0,0,0,0,0,0,0,0,0,0,0,0,0,0,0,0,0,0,0,0,0,0,0,0,0,0,0,0,0,0,0,0,0,0,0,0,0,0,0,0,
0,0,0,0,0,0,0,0,0,0,0,0,0,0,0,0,0,0,0,0,0,0,0,0,0,0,0,0,0,0,0,0,0,0,0,0,0,0,0,0
</data>
 </layer>
 <layer name="配置２" width="40" height="40">
  <data encoding="csv">
0,0,0,0,0,0,0,0,0,0,0,0,0,0,0,0,0,0,0,0,0,0,0,0,0,0,0,0,0,0,0,0,0,0,0,0,0,0,0,0,
0,0,0,0,0,0,0,0,0,0,0,0,0,0,0,0,0,0,0,0,0,0,0,0,0,0,0,0,0,0,0,0,0,0,0,0,0,0,0,0,
0,0,0,0,0,0,0,0,0,0,0,0,0,0,0,0,0,0,0,0,0,0,0,0,0,0,0,0,0,0,0,0,0,0,0,0,0,0,0,0,
0,0,0,0,0,0,0,0,0,0,0,0,0,0,0,0,0,0,0,0,0,0,0,0,0,0,0,0,0,0,0,0,0,0,0,0,0,0,0,0,
0,0,0,0,0,0,0,0,0,0,0,0,0,0,0,0,0,0,0,0,0,0,0,0,0,0,0,0,0,0,0,0,0,0,0,0,0,0,0,0,
0,0,0,0,0,0,0,0,0,0,0,0,0,0,0,0,3094,3095,3096,3097,3098,3099,3100,3101,0,0,0,0,0,0,0,0,0,0,0,0,0,0,0,0,
0,0,0,0,0,0,0,0,0,0,0,0,0,0,0,0,3256,3257,3258,3259,3260,3261,3262,3263,0,0,0,0,0,0,0,0,0,0,0,0,0,0,0,0,
0,0,0,0,0,0,0,0,0,0,0,0,0,0,0,0,3418,3419,3420,3421,3422,3423,3424,3425,0,0,0,0,0,0,0,0,0,0,0,0,0,0,0,0,
0,0,0,0,0,0,0,0,0,0,0,0,0,0,0,0,3580,3581,3582,3583,3584,3585,3586,3587,0,0,0,0,0,0,0,0,0,0,0,0,0,0,0,0,
0,0,0,0,0,0,0,0,0,0,0,0,0,0,0,0,3742,3743,3744,3745,3746,3747,3748,3749,0,0,0,0,0,0,0,0,0,0,0,0,0,0,0,0,
0,0,0,0,0,0,0,0,0,0,0,0,0,0,0,0,3904,3905,3906,3907,3908,3909,3910,3911,0,0,0,0,0,0,0,0,0,0,0,0,0,0,0,0,
0,0,0,0,0,0,0,0,0,0,0,0,0,0,0,0,0,0,0,0,0,0,0,0,0,0,0,0,0,0,0,0,0,0,0,0,0,0,0,0,
0,0,0,0,0,0,0,0,0,0,0,0,0,0,0,0,0,0,0,0,0,0,0,0,0,0,0,0,0,0,0,0,0,0,0,0,0,0,0,0,
0,0,0,0,0,0,0,0,0,0,0,0,0,0,0,0,0,0,0,0,0,0,0,0,0,0,0,0,0,0,0,0,0,0,0,0,0,0,0,0,
0,0,0,0,0,0,0,0,0,0,0,0,0,0,0,0,0,0,0,0,0,0,0,0,0,0,0,0,0,0,0,0,0,0,0,0,0,0,0,0,
0,0,0,0,0,0,0,0,0,0,0,0,0,0,0,0,0,0,0,0,0,0,0,0,0,0,0,0,0,0,0,0,0,0,0,0,0,0,0,0,
0,0,0,0,0,0,0,0,0,0,0,0,0,0,0,0,0,0,0,0,0,0,0,0,0,0,0,0,0,0,0,0,0,0,0,0,0,0,0,0,
0,0,0,0,0,0,0,0,0,0,0,0,0,0,0,0,0,0,0,0,0,0,0,0,0,0,0,0,0,0,0,0,0,0,0,0,0,0,0,0,
0,0,0,0,0,0,0,0,0,0,0,0,0,0,0,0,0,0,0,0,0,0,0,0,0,0,0,0,0,0,0,0,0,0,0,0,0,0,0,0,
0,0,0,0,0,4228,0,0,0,0,0,0,0,0,0,0,0,0,0,0,0,0,0,0,0,0,0,0,0,0,0,0,0,0,4390,0,0,0,0,0,
0,0,0,0,0,4390,0,0,0,0,0,0,0,0,0,0,0,0,0,0,0,0,0,0,0,0,0,0,0,0,0,0,0,0,4552,0,0,0,0,0,
0,0,0,0,0,4552,0,0,0,0,0,0,0,0,0,0,0,0,0,0,0,0,0,0,0,0,0,0,0,0,0,0,0,0,4714,0,0,0,0,0,
0,0,0,0,0,4714,0,0,0,0,0,0,0,0,0,0,0,0,0,0,0,0,0,0,0,0,0,0,0,0,0,0,0,0,4876,0,0,0,0,0,
0,0,0,0,0,0,0,0,0,0,0,0,0,0,0,0,0,0,0,0,0,0,0,0,0,0,0,0,0,0,0,0,0,0,0,0,0,0,0,0,
0,0,0,0,0,0,0,0,0,0,0,0,0,0,0,0,0,0,0,0,0,0,0,0,0,0,0,0,0,0,0,0,0,0,0,0,0,0,0,0,
0,0,0,0,0,0,0,0,0,0,0,0,0,0,0,0,0,0,0,0,0,0,0,0,0,0,0,0,0,0,0,0,0,0,0,0,0,0,0,0,
0,0,0,0,0,0,0,0,0,0,0,0,0,0,0,0,0,0,0,0,0,0,0,0,0,0,0,0,0,0,0,0,0,0,0,0,0,0,0,0,
0,0,0,0,0,0,0,0,0,0,0,0,0,0,0,0,0,0,0,0,0,0,0,0,0,0,0,0,0,0,0,0,0,0,0,0,0,0,0,0,
0,0,0,0,0,0,0,0,0,0,0,0,0,0,0,0,0,0,0,0,0,0,0,0,0,0,0,0,0,0,0,0,0,0,0,0,0,0,0,0,
0,0,0,0,0,0,0,0,0,0,0,0,0,0,0,0,0,0,0,0,0,0,0,0,0,0,0,0,0,0,0,0,0,0,0,0,0,0,0,0,
0,0,0,0,0,0,0,0,0,0,0,0,0,0,0,0,0,0,0,0,0,0,0,0,0,0,0,0,0,0,0,0,0,0,0,0,0,0,0,0,
0,0,0,0,0,0,0,0,0,0,0,0,0,0,0,0,0,0,0,0,0,0,0,0,0,0,0,0,0,0,0,0,0,0,0,0,0,0,0,0,
0,0,0,0,0,0,0,0,0,0,0,0,0,0,0,0,0,0,0,0,0,0,0,0,0,0,0,0,0,0,0,0,0,0,0,0,0,0,0,0,
0,0,0,0,0,0,0,0,0,0,0,0,0,0,0,0,0,0,0,0,0,0,0,0,0,0,0,0,0,0,0,0,0,0,0,0,0,0,0,0,
0,0,0,0,0,0,0,0,0,0,0,0,0,0,0,0,0,0,5038,5039,5040,5041,0,0,0,0,0,0,0,0,0,0,0,0,0,0,0,0,0,0,
0,0,0,0,0,0,0,0,0,0,0,0,0,0,0,0,0,0,0,0,0,0,0,0,0,0,0,0,0,0,0,0,0,0,0,0,0,0,0,0,
0,0,0,0,0,0,0,0,0,0,0,0,0,0,0,0,0,0,0,0,0,0,0,0,0,0,0,0,0,0,0,0,0,0,0,0,0,0,0,0,
0,0,0,0,0,0,0,0,0,0,0,0,0,0,0,0,0,0,0,0,0,0,0,0,0,0,0,0,0,0,0,0,0,0,0,0,0,0,0,0,
0,0,0,0,0,0,0,0,0,0,0,0,0,0,0,0,0,0,0,0,0,0,0,0,0,0,0,0,0,0,0,0,0,0,0,0,0,0,0,0,
0,0,0,0,0,0,0,0,0,0,0,0,0,0,0,0,0,0,0,0,0,0,0,0,0,0,0,0,0,0,0,0,0,0,0,0,0,0,0,0