40,40,3
1,1,1,1,1,1,1,1,1,1,1,1,1,1,1,1,1,1,1,1,1,1,1,1,1,1,1,1,1,1,1,1,1,1,1,1,1,1,1,1
1,1,1,1,1,1,1,1,1,1,1,1,1,1,1,1,1,1,1,1,1,1,1,1,1,1,1,1,1,1,1,1,1,1,1,1,1,1,1,1
1,1,1,1,1,1,1,1,1,1,1,1,1,1,1,1,1,1,1,1,1,1,1,1,1,1,1,1,1,1,1,1,1,1,1,1,1,1,1,1
1,1,1,1,1,1,1,1,1,1,1,1,1,1,1,1,1,1,1,1,1,1,1,1,1,1,1,1,1,1,1,1,1,1,1,1,1,1,1,1
1,1,1,1,1,1,1,1,1,1,1,1,1,1,1,1,1,1,1,1,1,1,1,1,1,1,1,1,1,1,1,1,1,1,1,1,1,1,1,1
1,1,1,1,1,1,1,1,1,1,1,1,1,1,1,1,1,1,1,1,1,1,1,1,1,1,1,1,1,1,1,1,1,1,1,1,1,1,1,1
1,1,1,1,1,1,1,1,1,1,1,1,1,1,1,1,1,1,0,0,0,0,1,1,1,1,1,1,1,1,1,1,1,1,1,1,1,1,1,1
1,1,1,1,1,1,1,1,1,1,1,1,1,1,1,1,1,1,0,0,0,0,1,1,1,1,1,1,1,1,1,1,1,1,1,1,1,1,1,1
1,1,1,1,1,1,1,1,1,1,1,1,1,1,1,1,1,1,0,0,0,0,1,1,1,1,1,1,1,1,1,1,1,1,1,1,1,1,1,1
1,1,1,1,1,1,1,0,0,0,0,0,0,0,0,0,1,1,0,0,0,0,1,1,0,0,0,0,0,0,0,0,0,1,1,1,1,1,1,1
1,1,1,1,1,1,1,0,0,0,0,0,0,0,0,0,1,1,0,0,0,0,1,1,0,0,0,0,0,0,0,0,0,1,1,1,1,1,1,1
1,1,1,1,1,1,1,0,0,0,0,0,0,0,0,0,0,0,0,0,0,0,0,0,0,0,0,0,0,0,0,0,0,1,1,1,1,1,1,1
1,1,1,1,1,1,1,0,0,0,0,0,0,0,0,0,0,0,0,0,0,0,0,0,0,0,0,0,0,0,0,0,0,1,1,1,1,1,1,1
1,1,1,1,1,1,1,0,0,0,0,0,0,0,0,0,0,0,0,0,0,0,0,0,0,0,0,0,0,0,0,0,0,1,1,1,1,1,1,1
1,1,1,1,1,1,1,0,0,0,0,0,0,0,0,0,0,0,0,0,0,0,0,0,0,0,0,0,0,0,0,0,0,1,1,1,1,1,1,1
1,1,1,1,1,1,1,0,0,0,0,0,0,0,0,0,0,0,0,0,0,0,0,0,0,0,0,0,0,0,0,0,0,1,1,1,1,1,1,1
1,1,1,1,1,1,1,0,0,0,0,0,0,0,0,0,0,0,0,0,0,0,0,0,0,0,0,0,0,0,0,0,0,1,1,1,1,1,1,1
1,1,1,1,1,1,1,0,0,0,0,0,0,0,0,0,0,0,0,0,0,0,0,0,0,0,0,0,0,0,0,0,0,1,1,1,1,1,1,1
1,1,1,1,1,1,1,0,0,0,0,0,0,0,0,0,0,0,0,0,0,0,0,0,0,0,0,0,0,0,0,0,0,1,1,1,1,1,1,1
1,1,1,1,1,1,1,1,1,1,1,1,1,1,1,1,1,1,1,1,1,1,1,1,1,0,0,0,0,0,0,0,0,1,1,1,1,1,1,1
1,1,1,1,1,1,1,1,1,1,1,1,1,1,1,1,1,1,1,1,1,1,1,1,1,0,0,0,0,0,0,0,0,1,1,1,1,1,1,1
1,1,1,1,1,1,1,1,1,1,1,1,1,1,1,1,1,1,1,1,1,1,1,1,1,0,0,0,0,0,0,0,0,0,0,1,1,1,1,1
1,1,1,1,1,1,1,1,1,1,1,1,1,1,1,1,1,1,1,1,1,1,1,1,1,0,0,0,0,0,0,0,0,0,0,1,1,1,1,1
1,1,1,1,1,0,0,0,0,0,0,0,0,0,0,0,0,0,0,1,1,1,1,1,0,0,0,0,0,0,0,0,0,0,0,1,1,1,1,1
1,1,1,1,1,0,0,0,0,0,0,0,0,0,0,0,0,0,0,1,1,1,1,1,0,0,0,0,0,0,0,0,0,0,0,1,1,1,1,1
1,1,1,1,1,0,0,1,1,1,1,1,1,1,1,0,0,0,0,1,1,1,1,1,0,0,0,0,0,0,0,0,1,1,0,1,1,1,1,1
1,1,1,1,1,0,0,0,0,1,1,1,1,1,1,0,0,0,0,1,1,1,1,1,0,0,0,0,0,0,0,1,1,1,0,1,1,1,1,1
1,1,1,1,1,0,0,0,0,1,1,1,1,1,1,0,0,0,0,1,1,0,0,0,0,0,0,0,0,0,1,1,1,1,0,1,1,1,1,1
1,1,1,1,1,0,0,0,0,1,1,1,1,1,1,0,0,0,0,1,1,0,0,0,0,0,0,0,0,0,1,1,1,1,1,1,1,1,1,1
1,1,1,1,1,0,0,0,0,0,1,1,1,1,1,0,0,0,0,0,0,0,0,0,0,0,0,0,0,0,1,1,1,1,1,1,1,1,1,1
1,1,1,1,1,0,1,1,1,1,1,1,1,1,1,0,0,0,0,0,0,0,0,0,0,0,0,0,0,0,1,1,1,1,1,1,1,1,1,1
1,1,1,1,1,0,1,1,1,1,0,0,0,0,1,0,0,0,0,0,0,0,0,0,0,0,0,0,0,0,1,1,1,1,1,1,1,1,1,1
1,1,1,1,1,0,1,1,1,1,0,0,0,0,1,0,0,0,0,0,0,0,0,0,0,0,0,0,0,0,1,1,1,1,1,1,1,1,1,1
1,1,1,1,1,0,1,1,1,1,0,0,0,0,1,0,0,0,0,0,0,0,0,0,0,0,0,0,0,0,1,1,1,1,1,1,1,1,1,1
1,1,1,1,1,0,0,0,0,0,0,0,0,0,1,0,0,0,0,0,0,0,0,0,0,0,0,0,0,0,0,0,0,0,0,1,1,1,1,1
1,1,1,1,1,1,1,1,1,1,1,1,1,1,1,1,1,1,1,1,1,1,1,1,1,1,1,1,1,1,1,1,1,1,1,1,1,1,1,1
1,1,1,1,1,1,1,1,1,1,1,1,1,1,1,1,1,1,1,1,1,1,1,1,1,1,1,1,1,1,1,1,1,1,1,1,1,1,1,1
1,1,1,1,1,1,1,1,1,1,1,1,1,1,1,1,1,1,1,1,1,1,1,1,1,1,1,1,1,1,1,1,1,1,1,1,1,1,1,1
1,1,1,1,1,1,1,1,1,1,1,1,1,1,1,1,1,1,1,1,1,1,1,1,1,1,1,1,1,1,1,1,1,1,1,1,1,1,1,1
1,1,1,1,1,1,1,1,1,1,1,1,1,1,1,1,1,1,1,1,1,1,1,1,1,1,1,1,1,1,1,1,1,1,1,1,1,1,1,1

6183,6184,6185,6186,6183,6184,6185,6186,6186,6186,6186,6186,6186,6348,6348,6348,6186,6186,6186,6186,6186,6186,6186,6186,6186,6186,6186,6186,6186,6186,6186,6186,6186,6348,6348,6186,6186,6186,6186,6186
6183,6184,6185,6186,6345,6346,6347,6348,6348,6348,6348,6348,6348,6510,6510,6510,6348,6348,6348,6348,6348,6348,6348,6348,6348,6348,6348,6348,6348,6348,6348,6348,6348,6510,6510,6348,6348,6348,6348,6348
6183,6184,6185,6186,6507,6508,6509,6510,6510,6510,6510,6510,6510,6672,6672,6672,6510,6510,6510,6510,6510,6510,6510,6510,6510,6510,6510,6510,6510,6510,6510,6510,6510,6672,6672,6510,6510,6510,6510,6510
6183,6184,6185,6186,6669,6670,6671,6672,6672,6672,6672,6672,6672,6670,6671,6672,6672,6672,6672,6672,6672,6672,6672,6672,6672,6672,6672,6672,6672,6672,6672,6672,6672,6671,6672,6672,6672,6672,6672,6672
6183,6184,6185,6186,109,110,110,110,110,110,110,110,110,110,110,110,110,110,110,110,110,110,110,110,110,110,110,110,110,110,111,110,111,112,113,114,6669,6670,6671,6672
6183,6184,6185,6186,147,6383,6383,6383,6383,6383,6383,6383,6383,6383,6383,6383,6383,6383,6383,6383,6383,6383,6383,6383,6383,6383,6383,6383,6383,6383,6383,6383,6383,6383,6383,152,6669,6670,6671,6672
6183,6184,6185,6186,147,6383,6383,6383,6383,6383,6383,6383,6383,6383,6383,6383,6383,6383,6383,6383,6383,6383,6383,6383,6383,6383,6383,6383,6383,6383,6383,6383,6383,6383,6383,152,6669,6670,6671,6672
6183,6184,6185,6186,147,6383,6383,6383,6383,6383,6383,6383,6383,6383,6383,6383,6383,6383,6383,6383,6383,6383,6383,6383,6383,6383,6383,6383,6383,6383,6383,6383,6383,6383,6383,152,6669,6670,6671,6672
6183,6184,6185,6186,147,6383,6383,6383,6383,6383,6383,6383,6383,6383,6383,6383,6383,6383,6383,6383,6383,6383,6383,6383,6383,6383,6383,6383,6383,6383,6383,6383,6383,6383,6383,152,6669,6670,6671,6672
6183,6184,6185,6186,147,6383,6383,6383,6383,6383,6383,6383,6383,6383,6383,6383,6383,6383,6383,6383,6383,6383,6383,6383,6383,6383,6383,6383,6383,6383,6383,6383,6383,6383,6383,152,6669,6670,6671,6672
6183,6184,6185,6186,147,6383,6383,6383,6383,6383,6383,6383,6383,6383,6383,6383,6383,6383,6383,6383,6383,6383,6383,6383,6383,6383,6383,6383,6383,6383,6383,6383,6383,6383,6383,152,6669,6670,6671,6672
6183,6184,6185,6186,147,6383,6383,6383,6383,6383,6383,6383,6383,6383,6383,6383,6383,6383,6383,6383,6383,6383,6383,6383,6383,6383,6383,6383,6383,6383,6383,6383,6383,6383,6383,152,6669,6670,6671,6672
6183,6184,6185,6186,147,6383,6383,6383,6383,6383,6383,6383,6383,6383,6383,6383,6383,6383,6383,6383,6383,6383,6383,6383,6383,6383,6383,6383,6383,6383,6383,6383,6383,6383,6383,152,6669,6670,6671,6672
6183,6184,6185,6186,147,6383,6383,6383,6383,6383,6383,6383,6383,6383,6383,6383,6383,6383,6383,6383,6383,6383,6383,6383,6383,6383,6383,6383,6383,6383,6383,6383,6383,6383,6383,152,6669,6670,6671,6672
6183,6184,6185,6186,147,6383,6383,6383,6383,6383,6383,6383,6383,6383,6383,6383,6383,6383,6383,6383,6383,6383,6383,6383,6383,6383,6383,6383,6383,6383,6383,6383,6383,6383,6383,152,6507,6508,6509,6510
6183,6184,6185,6186,147,6383,6383,6383,6383,6383,6383,6383,6383,6383,6383,6383,6383,6383,6383,6383,6383,6383,6383,6383,6383,6383,6383,6383,6383,6383,6383,6383,6383,6383,6383,152,6669,6670,6671,6672
6183,6184,6185,6186,147,6383,6383,6383,6383,6383,6383,6383,6383,6383,6383,6383,6383,6383,6383,6383,6383,6383,6383,6383,6383,6383,6383,6383,6383,6383,6383,6383,6383,6383,6383,152,6669,6670,6671,6672
6183,6184,6185,6186,147,6383,6383,6383,6383,6383,6383,6383,6383,6383,6383,6383,6383,6383,6383,6383,6383,6383,6383,6383,6383,6383,6383,6383,6383,6383,6383,6383,6383,6383,6383,152,6669,6670,6671,6672
6183,6184,6185,6186,147,6383,6383,6383,6383,6383,6383,6383,6383,6383,6383,6383,6383,6383,6383,6383,6383,6383,6383,6383,6383,6383,6383,6383,6383,6383,6383,6383,6383,6383,6383,152,6669,6670,6671,6672
6183,6184,6185,6186,147,6383,6383,6383,6383,6383,6383,6383,6383,6383,6383,6383,6383,6383,6383,6383,6383,6383,6383,6383,6383,6383,6383,6383,6383,6383,6383,6383,6383,6383,6383,152,6669,6670,6671,6672
6345,6346,6347,6348,147,6383,6383,6383,6383,6383,6383,6383,6383,6383,6383,6383,6383,6383,6383,6383,6383,6383,6383,6383,6383,6383,6383,6383,6383,6383,6383,6383,6383,6383,6383,152,6669,6670,6671,6672
6507,6508,6509,6510,147,6383,6383,6383,6383,6383,6383,6383,6383,6383,6383,6383,6383,6383,6383,6383,6383,6383,6383,6383,6383,6383,6383,6383,6383,6383,6383,6383,6383,6383,6383,152,6507,6669,6670,6671
6669,6670,6671,6672,147,6383,6383,6383,6383,6383,6383,6383,6383,6383,6383,6383,6383,6383,6383,6383,6383,6383,6383,6383,6383,6383,6383,6383,6383,6383,6383,6383,6383,6383,6383,152,6669,6670,6671,6672
6183,6184,6185,6186,147,6383,6383,6383,6383,6383,6383,6383,6383,6383,6383,6383,6383,6383,6383,6383,6383,6383,6383,6383,6383,6383,6383,6383,6383,6383,6383,6383,6383,6383,6383,152,6669,6670,6671,6672
6183,6184,6185,6186,147,6383,6383,6383,6383,6383,6383,6383,6383,6383,6383,6383,6383,6383,6383,6383,6383,6383,6383,6383,6383,6383,6383,6383,6383,6383,6383,6383,6383,6383,6383,152,6669,6670,6671,6672
6183,6184,6185,6186,147,6383,6383,6383,6383,6383,6383,6383,6383,6383,6383,6383,6383,6383,6383,6383,6383,6383,6383,6383,6383,6383,6383,6383,6383,6383,6383,6383,6383,6383,6383,152,6669,6670,6671,6672
6183,6184,6185,6186,147,6383,6383,6383,6383,6383,6383,6383,6383,6383,6383,6383,6383,6383,6383,6383,6383,6383,6383,6383,6383,6383,6383,6383,6383,6383,6383,6383,6383,6383,6383,152,6669,6670,6671,6672
6183,6184,6185,6186,147,6383,6383,6383,6383,6383,6383,6383,6383,6383,6383,6383,6383,6383,6383,6383,6383,6383,6383,6383,6383,6383,6383,6383,6383,6383,6383,6383,6383,6383,6383,152,6345,6346,6347,6348
6183,6184,6185,6186,147,6383,6383,6383,6383,6383,6383,6383,6383,6383,6383,6383,6383,6383,6383,6383,6383,6383,6383,6383,6383,6383,6383,6383,6383,6383,6383,6383,6383,6383,6383,152,6507,6508,6509,6510
6183,6184,6185,6186,147,6383,6383,6383,6383,6383,6383,6383,6383,6383,6383,6383,6383,6383,6383,6383,6383,6383,6383,6383,6383,6383,6383,6383,6383,6383,6383,6383,6383,6383,6383,152,6669,6670,6671,6672
6183,6184,6185,6186,147,6383,6383,6383,6383,6383,6383,6383,6383,6383,6383,6383,6383,6383,6383,6383,6383,6383,6383,6383,6383,6383,6383,6383,6383,6383,6383,6383,6383,6383,6383,152,6345,6669,6670,6671
6183,6184,6185,6186,147,6383,6383,6383,6383,6383,6383,6383,6383,6383,6383,6383,6383,6383,6383,6383,6383,6383,6383,6383,6383,6383,6383,6383,6383,6383,6383,6383,6383,6383,6383,152,6507,6669,6670,6671
6183,6184,6185,6186,185,6383,6383,6383,6383,6383,6383,6383,6383,6383,6383,6383,6383,6383,6383,6383,6383,6383,6383,6383,6383,6383,6383,6383,6383,6383,6383,6383,6383,6383,6383,190,6669,6669,6670,6671
6183,6184,6185,6186,223,6383,6383,6383,6383,6383,6383,6383,6383,6383,6383,6383,6383,6383,6383,6383,6383,6383,6383,6383,6383,6383,6383,6383,6383,6383,6383,6383,6383,6383,6383,228,6669,6670,6671,6672
6183,6184,6185,6186,261,6383,6383,6383,6383,6383,6383,6383,6383,6383,6383,6383,6383,6383,6383,6383,6383,6383,6383,6383,6383,6383,6383,6383,6383,6383,6383,6383,6383,6383,6383,266,6669,6670,6671,6672
6183,6184,6185,6186,299,300,300,300,300,300,300,300,300,300,300,300,300,300,300,300,300,300,300,300,300,300,300,300,300,300,300,300,301,302,303,304,6669,6670,6671,6672
6183,6184,6185,6186,6183,6183,6183,6183,6183,6183,6183,6183,6183,6183,6183,6183,6183,6183,6183,6183,6183,6183,6183,6183,6183,6183,6183,6183,6183,6183,6183,6183,6183,6183,6183,6183,6669,6670,6671,6672
6345,6346,6347,6348,6345,6345,6345,6345,6345,6345,6345,6345,6345,6345,6345,6345,6345,6345,6345,6345,6345,6345,6345,6345,6345,6345,6345,6345,6345,6345,6345,6345,6345,6345,6345,6345,6669,6670,6671,6672
6507,6508,6509,6510,6507,6507,6507,6507,6507,6507,6507,6507,6507,6507,6507,6507,6507,6507,6507,6507,6507,6507,6507,6507,6507,6507,6507,6507,6507,6507,6507,6507,6507,6507,6507,6507,6669,6670,6671,6672
6669,6670,6671,6672,6669,6669,6669,6669,6669,6669,6669,6669,6669,6669,6669,6669,6669,6669,6669,6669,6669,6669,6669,6669,6669,6669,6669,6669,6669,6669,6669,6669,6669,6669,6669,6669,6669,6670,6671,6672

0,0,0,0,0,0,0,0,0,0,0,0,0,0,0,0,0,0,0,0,0,0,0,0,0,0,0,0,0,0,0,0,0,0,0,0,0,0,0,0
0,0,0,0,0,0,0,0,0,0,0,0,0,0,0,0,0,0,0,0,0,0,0,0,0,0,0,0,0,0,0,0,0,0,0,0,0,0,0,0
0,0,0,0,0,0,0,0,0,0,0,0,0,0,0,0,0,0,0,0,0,0,0,0,0,0,0,0,0,0,0,0,0,0,0,0,0,0,0,0
0,0,0,0,0,0,0,0,0,0,0,0,0,0,0,0,0,0,0,0,0,0,0,0,0,0,0,0,0,0,0,0,0,0,0,0,0,0,0,0
0,0,0,0,0,0,0,0,0,0,0,0,0,0,0,0,0,0,0,0,0,0,0,0,0,0,0,0,0,0,0,0,0,0,0,0,0,0,0,0
0,0,0,0,0,311,312,313,314,315,316,317,318,311,312,313,314,315,0,0,0,0,312,313,314,315,316,317,318,311,312,313,314,315,316,0,0,0,0,0
0,0,0,0,0,473,474,475,476,477,478,479,480,473,474,475,476,477,0,0,0,0,474,475,476,477,478,479,480,473,474,475,476,477,478,0,0,0,0,0
0,0,0,0,0,311,312,313,314,315,316,317,318,311,312,313,314,315,0,0,0,0,312,313,314,315,316,317,318,311,312,313,314,315,316,0,0,0,0,0
0,0,0,0,0,473,474,475,476,477,478,479,480,473,474,475,476,477,0,0,0,0,474,475,476,477,478,479,480,473,474,475,476,477,478,0,0,0,0,0
0,0,0,0,0,0,0,0,0,0,0,0,0,0,0,0,0,0,0,0,0,0,0,0,0,0,0,0,0,0,0,0,0,0,0,0,0,0,0,0
0,0,0,0,0,0,0,0,0,0,0,0,0,0,0,0,0,0,0,0,0,0,0,0,0,0,0,0,0,0,0,0,0,0,0,0,0,0,0,0
0,0,0,0,0,0,0,0,0,0,0,0,0,0,0,0,0,0,0,0,0,0,0,0,0,0,0,0,0,0,0,0,0,0,0,0,0,0,0,0
0,0,0,0,0,0,0,0,0,0,0,0,0,0,0,0,0,0,0,0,0,0,0,0,0,0,0,0,0,0,0,0,0,0,0,0,0,0,0,0
0,0,0,0,0,0,0,0,0,0,0,0,0,0,0,0,0,0,0,0,0,0,0,0,0,0,0,0,0,0,0,0,0,0,0,0,0,0,0,0
0,0,0,0,0,0,0,0,0,0,0,0,0,0,0,0,0,0,0,0,0,0,0,0,0,0,0,0,0,0,0,0,0,0,0,0,0,0,0,0
0,0,0,0,0,0,0,0,0,0,0,0,0,0,0,0,0,0,0,0,0,0,0,0,0,0,0,0,0,0,0,0,0,0,0,0,0,0,0,0
0,0,0,0,0,0,0,0,0,0,0,0,0,0,0,0,0,0,0,0,0,0,0,0,0,0,0,0,0,0,0,0,0,0,0,0,0,0,0,0
0,0,0,0,0,0,0,0,0,0,0,0,0,0,0,0,0,0,0,0,0,0,0,0,0,0,0,0,0,0,0,0,0,0,0,0,0,0,0,0
0,0,0,0,0,0,0,0,0,0,0,0,0,0,0,0,0,0,0,0,0,0,0,0,0,0,0,0,0,0,0,0,0,0,0,0,0,0,0,0
0,0,0,0,0,0,0,0,0,0,0,0,0,0,0,0,0,0,0,0,0,0,0,0,0,0,0,0,0,0,0,0,0,0,0,0,0,0,0,0
0,0,0,0,0,0,0,0,0,0,0,0,0,0,0,0,0,0,0,0,0,0,0,0,0,0,0,0,0,0,0,0,0,0,0,0,0,0,0,0
0,0,0,0,0,0,0,0,0,0,0,0,0,0,0,0,0,0,0,0,0,0,0,0,0,0,0,0,0,0,0,0,0,0,0,0,0,0,0,0
0,0,0,0,0,0,0,0,0,0,0,0,0,0,0,0,0,0,0,0,0,0,0,0,0,0,0,0,0,0,0,0,0,0,0,0,0,0,0,0
0,0,0,0,0,0,0,0,0,0,0,0,0,0,0,0,0,0,0,4584,4585,4586,4587,4588,0,0,0,0,0,0,0,0,0,0,0,0,0,0,0,0
0,0,0,0,0,0,0,0,0,0,0,0,0,0,0,0,0,0,0,4746,4747,4748,4749,4750,0,0,0,0,0,0,0,0,0,0,0,0,0,0,0,0
0,0,0,0,0,0,0,0,0,8031,8032,8033,8034,0,0,0,0,0,0,4908,4909,4910,4911,4912,0,0,0,0,0,0,0,0,0,0,0,0,0,0,0,0
0,0,0,0,0,0,0,0,0,8063,8064,8065,8066,0,0,0,0,0,0,5070,5071,5072,5073,5074,0,0,0,0,0,0,0,0,0,0,0,0,0,0,0,0
0,0,0,0,0,0,0,0,0,8095,8096,8097,8098,0,0,0,0,0,0,0,0,0,0,0,0,0,0,0,0,0,0,0,0,0,0,0,0,0,0,0
0,0,0,0,0,0,0,0,0,8127,8128,8129,8130,0,0,0,0,0,0,0,0,0,0,0,0,0,0,0,0,0,0,0,0,0,0,0,0,0,0,0
0,0,0,0,0,0,0,0,0,0,0,0,0,0,0,0,0,0,0,0,0,0,0,0,0,0,0,0,0,0,0,0,0,0,0,0,0,0,0,0
0,0,0,0,0,0,0,0,0,0,0,0,0,0,0,0,0,0,0,0,0,0,0,0,0,0,0,0,0,0,0,0,0,0,0,0,0,0,0,0
0,0,0,0,0,0,0,0,0,0,0,0,0,0,0,0,0,0,0,0,0,0,0,0,0,0,0,0,0,0,0,0,0,0,0,0,0,0,0,0
0,0,0,0,0,0,0,0,0,0,0,0,0,0,0,0,0,0,0,0,0,0,0,0,0,0,0,0,0,0,0,0,0,0,0,0,0,0,0,0
0,0,0,0,0,0,0,0,0,0,0,0,0,0,0,0,0,0,0,0,0,0,0,0,0,0,0,0,0,0,0,0,0,0,0,0,0,0,0,0
0,0,0,0,0,0,0,0,0,0,0,0,0,0,0,0,0,0,0,0,0,0,0,0,0,0,0,0,0,0,0,0,0,0,0,0,0,0,0,0
0,0,0,0,0,0,0,0,0,0,0,0,0,0,0,0,0,0,0,0,0,0,0,0,0,0,0,0,0,0,0,0,0,0,0,0,0,0,0,0
0,0,0,0,0,0,0,0,0,0,0,0,0,0,0,0,0,0,0,0,0,0,0,0,0,0,0,0,0,0,0,0,0,0,0,0,0,0,0,0
0,0,0,0,0,0,0,0,0,0,0,0,0,0,0,0,0,0,0,0,0,0,0,0,0,0,0,0,0,0,0,0,0,0,0,0,0,0,0,0
0,0,0,0,0,0,0,0,0,0,0,0,0,0,0,0,0,0,0,0,0,0,0,0,0,0,0,0,0,0,0,0,0,0,0,0,0,0,0,0
0,0,0,0,0,0,0,0,0,0,0,0,0,0,0,0,0,0,0,0,0,0,0,0,0,0,0,0,0,0,0,0,0,0,0,0,0,0,0,0

0,0,0,0,0,0,0,0,0,0,0,0,0,0,0,0,0,0,0,0,0,0,0,0,0,0,0,0,0,0,0,0,0,0,0,0,0,0,0,0
0,0,0,0,0,0,0,0,0,0,0,0,0,0,0,0,0,0,0,0,0,0,0,0,0,0,0,0,0,0,0,0,0,0,0,0,0,0,0,0
0,0,0,0,0,0,0,0,0,0,0,0,0,0,0,0,0,0,0,0,0,0,0,0,0,0,0,0,0,0,0,0,0,0,0,0,0,0,0,0
0,0,0,0,0,0,0,0,0,0,0,0,0,0,0,0,0,0,0,0,0,0,0,0,0,0,0,0,0,0,0,0,0,0,0,0,0,0,0,0
0,0,0,0,0,0,0,0,0,0,0,0,0,0,0,0,0,0,0,0,0,0,0,0,0,0,0,0,0,0,0,0,0,0,0,0,0,0,0,0
0,0,0,0,0,0,0,0,0,0,0,0,0,0,0,0,3094,3095,3096,3097,3098,3099,3100,3101,0,0,0,0,0,0,0,0,0,0,0,0,0,0,0,0
0,0,0,0,0,0,0,0,0,0,0,0,0,0,0,0,3256,3257,0,0,0,0,3262,3263,0,0,0,0,0,0,0,0,0,0,0,0,0,0,0,0
0,0,0,0,0,0,0,0,0,0,0,0,0,0,0,0,3418,3419,0,0,0,0,3424,3425,0,0,0,0,0,0,0,0,0,0,0,0,0,0,0,0
0,0,0,0,0,0,0,0,0,0,0,0,0,0,0,0,3580,3581,0,0,0,0,3586,3587,0,0,0,0,0,0,0,0,0,0,0,0,0,0,0,0
0,0,0,0,0,5607,5608,0,0,0,0,0,0,0,0,0,3742,3743,0,0,0,0,3748,3749,0,0,0,0,0,0,0,0,0,5939,5940,0,0,0,0,0
0,0,0,0,0,5769,5770,0,0,0,0,0,0,0,0,0,3904,3905,3906,3907,3908,0,3910,3911,0,0,0,0,0,0,0,0,0,6101,6102,0,0,0,0,0
0,0,0,0,0,5939,5940,0,0,0,0,0,0,0,0,0,0,0,0,0,0,0,0,0,0,0,0,0,0,0,0,0,0,6263,6264,0,0,0,0,0
0,0,0,0,0,6101,6102,0,0,0,0,0,0,0,0,0,0,0,0,0,0,0,0,0,0,0,0,0,0,0,0,0,0,6425,6426,0,0,0,0,0
0,0,0,0,0,6263,6264,0,0,0,0,0,0,0,0,0,0,0,0,0,0,0,0,0,0,0,0,0,0,0,0,0,0,5939,5940,0,0,0,0,0
0,0,0,0,0,6425,6426,0,0,0,8533,8534,0,0,0,0,0,0,0,8533,8534,0,0,0,0,0,0,0,0,0,0,0,0,6101,6102,0,0,0,0,0
0,0,0,0,0,5939,5940,0,0,8533,8565,8566,8534,0,0,0,0,0,8533,8565,8566,8534,0,0,0,0,0,0,0,0,0,0,0,6263,6264,0,0,0,0,0
0,0,0,0,0,6101,6102,0,8533,8565,8566,8565,8566,8534,0,0,0,8533,8565,8566,8565,8566,8534,0,0,0,0,0,0,0,0,0,0,6425,6426,0,0,0,0,0
0,0,0,0,0,6263,6264,8533,8565,8566,8565,8566,8565,8566,8534,0,8533,8565,8566,8565,8566,8565,8566,8534,0,0,0,0,0,0,0,0,0,5939,5940,0,0,0,0,0
0,0,0,0,0,6425,6426,8565,8566,8565,8566,8565,8566,8565,8566,0,8565,8566,8565,8566,8565,8566,8565,8566,0,0,0,0,0,0,0,0,0,6101,6102,0,0,0,0,0
0,0,0,0,0,5939,5940,5939,5940,5939,5940,5939,5940,5939,5940,5939,5940,5939,5940,5939,5940,5939,5940,5939,5940,0,0,0,0,0,0,0,0,6263,6264,0,0,0,0,0
0,0,0,0,0,6101,6102,6101,6102,6101,6102,6101,6102,6101,6102,6101,6102,6101,6102,6101,6102,6101,6102,6101,6102,0,0,0,0,0,0,0,0,6425,6426,0,0,0,0,0
0,0,0,0,0,6263,6264,6263,6264,6263,6264,6263,6264,6263,6264,6263,6264,6263,6264,6263,6264,6263,6264,6263,6264,0,0,0,0,0,0,0,0,0,0,0,0,0,0,0
0,0,0,0,0,6425,6426,6425,6426,6425,6426,6425,6426,6425,6426,6425,6426,6425,6426,6425,6426,6425,6426,6425,6426,0,0,0,0,0,0,0,0,0,0,0,0,0,0,0
0,0,0,0,0,0,0,0,0,0,0,0,0,0,0,0,0,0,0,0,0,0,0,0,0,0,0,0,0,0,0,0,0,0,0,0,0,0,0,0
0,0,0,0,0,0,0,0,0,0,0,0,0,0,0,0,0,0,0,0,0,0,0,0,0,0,0,0,0,0,0,0,0,0,0,0,0,0,0,0
0,0,0,0,0,0,0,7875,7883,0,0,0,0,7883,7884,0,0,0,0,0,0,0,0,0,0,0,0,0,0,0,2319,2320,2321,2322,2323,0,0,0,0,0
0,0,0,0,0,0,0,0,0,0,0,0,0,0,7916,0,0,0,0,5397,5398,0,0,0,0,0,0,0,0,0,2481,2482,2483,2484,2485,0,0,0,0,0
0,0,0,0,0,0,0,0,0,0,8489,8490,8491,8492,7948,0,0,0,0,5559,5560,0,0,0,0,0,0,0,0,0,2643,2644,2645,2646,2647,0,0,0,0,0
0,0,0,0,0,0,0,0,0,0,8521,8522,8523,8524,7916,0,0,0,0,5721,5722,0,0,0,0,0,0,0,0,0,2805,2806,2807,2808,2809,0,0,0,0,0
0,0,0,0,0,0,0,0,0,0,8553,8554,8555,8556,7948,0,0,0,0,0,0,0,0,0,0,0,0,0,0,0,2967,2968,2969,2970,2971,0,0,0,0,0
0,0,0,0,0,0,8745,8746,8747,8748,8585,8586,8587,8588,7916,0,0,0,0,0,0,0,0,0,0,0,0,0,0,0,3129,3130,3131,3132,3133,0,0,0,0,0
0,0,0,0,0,0,8777,8778,8779,8780,0,0,0,0,7948,0,0,0,0,0,0,0,0,0,0,0,0,0,0,0,3291,3292,3293,3294,3295,0,0,0,0,0
0,0,0,0,0,0,8681,8682,8683,8684,0,0,0,0,7916,0,0,0,0,0,0,0,0,0,0,0,0,0,0,0,3453,3454,3455,3456,3457,0,0,0,0,0
0,0,0,0,0,0,8713,8714,8715,8716,0,0,0,0,7916,0,0,0,0,0,0,0,0,0,0,0,0,0,0,0,3615,3616,3617,3618,3619,0,0,0,0,0
0,0,0,0,0,0,0,0,0,0,0,0,0,0,7948,0,0,0,0,0,0,0,0,0,0,0,0,0,0,0,0,0,0,0,0,0,0,0,0,0
0,0,0,0,0,0,0,0,0,0,0,0,0,0,0,0,0,0,0,0,0,0,0,0,0,0,0,0,0,0,0,0,0,0,0,0,0,0,0,0
0,0,0,0,0,0,0,0,0,0,0,0,0,0,0,0,0,0,0,0,0,0,0,0,0,0,0,0,0,0,0,0,0,0,0,0,0,0,0,0
0,0,0,0,0,0,0,0,0,0,0,0,0,0,0,0,0,0,0,0,0,0,0,0,0,0,0,0,0,0,0,0,0,0,0,0,0,0,0,0
0,0,0,0,0,0,0,0,0,0,0,0,0,0,0,0,0,0,0,0,0,0,0,0,0,0,0,0,0,0,0,0,0,0,0,0,0,0,0,0
0,0,0,0,0,0,0,0,0,0,0,0,0,0,0,0,0,0,0,0,0,0,0,0,0,0,0,0,0,0,0,0,0,0,0,0,0,0,0,0